76,77,77,77,77,77,77,77,77,77,77,77,77,77,77,77,77,77,77,77,77,77,77,77,77,77,77,77,77,77,77,77,77,77,77,77,77,77,77,77,77,77,77,77,77,77,77,77,77,78
91,48,04,26,26,26,26,26,26,26,26,26,26,26,26,26,26,26,26,26,26,26,26,26,26,26,26,26,26,26,05,90,48,04,26,26,26,26,26,26,26,26,26,26,26,26,26,26,05,92
91,48,15,00,00,00,00,00,00,00,12,00,00,01,02,02,02,02,02,02,02,02,02,02,03,00,00,00,00,24,13,88,48,15,01,02,02,06,02,02,02,02,02,02,02,06,02,03,13,92
91,48,15,12,00,00,00,24,00,00,00,00,24,13,40,40,28,40,40,33,40,07,29,40,15,00,12,00,00,00,13,88,48,15,13,14,14,18,14,14,14,14,34,35,14,18,14,15,13,92
91,48,16,02,02,03,00,00,00,01,02,02,02,17,89,51,50,50,50,50,50,50,50,50,15,00,00,00,24,00,13,88,48,15,13,89,50,30,50,50,65,50,50,50,50,30,50,15,13,92
91,48,57,40,59,15,00,00,00,13,40,29,40,59,88,48,48,48,48,42,48,48,48,48,16,06,02,02,02,02,17,88,48,16,17,88,48,48,48,48,66,48,48,48,48,48,48,16,17,92
91,48,57,40,59,15,24,00,12,13,89,50,50,50,48,48,48,48,48,48,48,48,48,48,57,18,40,34,35,40,59,88,48,57,59,36,37,37,37,37,37,37,37,37,37,37,38,57,59,92
91,48,50,51,50,16,02,02,02,17,88,48,49,48,48,48,48,48,48,48,48,48,48,48,50,30,50,50,50,50,50,48,48,48,48,48,48,48,48,48,48,48,48,48,48,48,48,16,17,92
91,48,48,48,48,57,40,45,40,59,88,48,48,48,48,48,48,42,48,48,48,48,48,48,48,48,48,48,48,48,48,48,48,48,48,48,48,48,48,48,48,48,48,48,48,48,48,50,50,92
91,48,49,48,48,50,50,50,50,50,53,69,70,70,70,70,70,70,70,54,70,70,70,70,70,70,70,70,70,70,54,70,70,70,70,70,70,70,70,70,70,70,70,70,70,70,70,56,48,92
48,48,48,48,48,50,50,50,50,50,53,83,48,48,42,48,48,48,48,48,48,48,48,48,48,48,48,48,48,48,48,48,48,48,04,26,26,26,26,26,26,26,26,26,26,05,90,83,48,92
48,79,70,70,70,70,54,70,70,70,70,87,48,48,48,48,48,48,48,04,26,26,26,26,26,26,26,26,26,26,05,90,48,48,15,24,00,00,00,00,00,00,00,00,24,13,88,83,74,92
91,48,49,48,48,48,48,48,48,48,48,48,48,48,48,04,26,26,26,00,00,00,01,02,02,02,02,02,02,02,17,76,77,77,15,00,00,00,00,12,00,01,02,02,02,17,88,83,48,92
91,04,26,26,26,26,05,90,48,48,48,63,48,48,48,16,02,02,03,00,00,24,13,40,40,28,40,20,28,40,59,88,48,48,15,00,00,00,00,00,00,13,40,28,28,59,88,83,48,92
91,15,00,00,24,00,13,88,48,48,48,48,48,48,48,57,40,40,15,24,00,00,13,89,50,50,50,32,50,50,50,53,48,48,15,12,00,00,00,24,00,13,89,50,50,50,53,83,48,92
91,15,00,00,00,00,13,88,48,48,48,48,83,48,48,51,50,82,16,02,02,02,17,88,48,48,48,48,63,48,48,48,48,48,15,00,00,00,00,00,00,13,88,48,48,48,48,83,48,92
91,16,02,02,03,00,13,88,48,48,48,48,83,48,48,48,48,48,57,40,40,40,59,88,48,48,48,48,48,48,48,48,48,48,16,02,02,02,02,02,02,17,88,48,48,48,48,83,48,92
91,57,40,40,16,02,17,88,48,48,48,48,83,48,48,48,48,48,50,50,50,50,50,53,48,48,48,48,48,48,48,48,48,48,57,40,40,28,28,40,40,59,88,48,48,48,48,83,48,92
91,50,51,50,57,40,40,88,48,48,48,48,85,70,70,70,70,70,54,70,70,70,70,70,70,70,70,70,70,54,70,70,70,70,70,70,70,70,70,70,70,70,70,70,70,70,70,87,48,92
76,77,77,77,77,77,77,77,77,77,77,77,77,77,77,77,77,77,77,77,77,77,77,77,77,77,77,77,77,77,77,77,77,77,77,77,77,77,77,77,77,77,77,77,77,77,77,77,77,78

1,1,1,1,1,1,1,1,1,1,1,1,1,1,1,1,1,1,1,1,1,1,1,1,1,1,1,1,1,1,1,1,1,1,1,1,1,1,1,1,1,1,1,1,1,1,1,1,1,1
1,0,1,1,1,1,1,1,1,1,1,1,1,1,1,1,1,1,1,1,1,1,1,1,1,1,1,1,1,1,1,0,0,1,1,1,1,1,1,1,1,1,1,1,1,1,1,1,1,1
1,0,0,0,0,0,0,0,0,0,0,0,0,1,1,1,1,1,1,1,1,1,1,1,1,0,0,0,0,0,0,0,0,0,1,1,1,1,1,1,1,1,1,1,1,1,1,1,0,1
1,0,0,0,0,0,0,0,0,0,0,0,0,0,0,0,0,0,0,0,0,1,0,0,0,0,0,0,0,0,0,0,0,0,0,0,0,0,0,0,0,0,0,0,0,0,0,0,0,1
1,0,1,1,1,1,0,0,0,1,1,1,1,1,0,0,0,0,0,0,0,0,0,0,0,0,0,0,0,0,0,0,0,0,0,0,0,0,0,0,1,0,0,0,0,0,0,0,0,1
1,0,0,0,0,0,0,0,0,0,0,0,0,0,0,0,0,0,0,0,0,0,0,0,1,1,1,1,1,1,1,0,0,1,1,0,0,0,0,0,0,0,0,0,0,0,0,1,1,1
1,0,0,0,0,0,0,0,0,0,0,0,0,0,0,0,0,0,0,0,0,0,0,0,0,0,0,0,0,0,0,0,0,0,0,0,0,0,0,0,0,0,0,0,0,0,0,0,0,1
1,0,0,0,0,1,1,1,1,1,0,0,0,0,0,0,0,0,0,0,0,0,0,0,0,0,0,0,0,0,0,0,0,0,0,0,0,0,0,0,0,0,0,0,0,0,0,1,1,1
1,0,0,0,0,0,0,0,0,0,0,0,0,0,0,0,0,0,0,0,0,0,0,0,0,0,0,0,0,0,0,0,0,0,0,0,0,0,0,0,0,0,0,0,0,0,0,0,0,1
1,0,0,0,0,0,0,0,0,0,0,0,0,0,0,0,0,0,0,0,0,0,0,0,0,0,0,0,0,0,0,0,0,0,0,0,0,0,0,0,0,0,0,0,0,0,0,1,0,1
0,0,0,0,0,0,0,0,0,0,0,0,0,0,0,0,0,0,0,0,0,0,0,0,0,0,0,0,0,0,0,0,0,0,1,1,1,1,1,1,1,1,1,1,1,1,0,0,0,1
0,0,0,0,0,0,0,0,0,0,0,0,0,0,0,0,0,0,0,1,1,1,1,1,1,1,1,1,1,1,1,0,0,0,0,0,0,0,0,0,0,0,0,0,0,0,0,0,1,1
1,0,0,0,0,0,0,0,0,0,0,0,0,0,0,1,1,1,1,0,0,0,1,1,1,1,1,1,1,1,1,1,1,1,0,0,0,0,0,0,0,1,1,1,1,1,0,0,0,1
1,1,1,1,1,1,1,0,0,0,0,1,0,0,0,1,1,1,1,0,0,0,0,0,0,0,0,0,0,0,0,0,0,0,0,0,0,0,0,0,0,0,0,0,0,0,0,0,0,1
1,0,0,0,0,0,0,0,0,0,0,0,0,0,0,0,0,0,0,0,0,0,0,0,0,0,0,0,0,0,0,0,0,0,0,0,0,0,0,0,0,0,0,0,0,0,0,0,0,1
1,0,0,0,0,0,0,0,0,0,0,0,0,0,0,0,0,1,1,1,1,1,1,0,0,0,0,0,1,0,0,0,0,0,0,0,0,0,0,0,0,0,0,0,0,0,0,0,0,1
1,1,1,1,1,0,0,0,0,0,0,0,0,0,0,0,0,0,0,0,0,0,0,0,0,0,0,0,0,0,0,0,0,0,1,1,1,1,1,1,1,1,0,0,0,0,0,0,0,1
1,0,0,0,1,1,1,0,0,0,0,0,0,0,0,0,0,0,0,0,0,0,0,0,0,0,0,0,0,0,0,0,0,0,0,0,0,0,0,0,0,0,0,0,0,0,0,0,0,1
1,0,0,0,0,0,0,0,0,0,0,0,0,0,0,0,0,0,0,0,0,0,0,0,0,0,0,0,0,0,0,0,0,0,0,0,0,0,0,0,0,0,0,0,0,0,0,0,0,1
1,1,1,1,1,1,1,1,1,1,1,1,1,1,1,1,1,1,1,1,1,1,1,1,1,1,1,1,1,1,1,1,1,1,1,1,1,1,1,1,1,1,1,1,1,1,1,1,1,1